


NO ./textures/walls/wall_2.xpm
EA ./textures/walls/wall_2.xpm
WE ./textures/walls/wall_2.xpm
S ./textures/enemy/enemy_Idle.xpm 
SO ./textures/walls/wall_2.xpm
F  ./textures/walls/floor_2.xpm
C ./textures/walls/ceiling.xpm
R 1900 1080

        1111111111111111111111111
        1000000000110000000000001
        101100A0011100000A0000001
        10H1000000000001000001001
111111111111001001110000000000001
1H00000000300000011101111101111112111111111111111111111111
1111011111111101110000001000111120211111111011100000010001
122202222222H2021101010010001122202222222H2021101010010001
120000002202320211000A001000112000000220232021100000010A01
2000000A00000000030000001000120000000A00000000300000000001
2001000000000022101010001000000020000000002221110100010001
1200000222020202111101111000122000002220203021111001110001
12220222 122H202 10111101000112222222 12202H2 101101H30001
11112111 1112121 1111111113111111111111112121 111101111111
                        1000000000000000H1111111110111111
                        11110111111111011100000010001
                        12220222222202021101010010001
                        12000000220232021100000010001
                        20000A00000000000300000010001
                        20020200000000211010100010001
                        12000002220202021111011110N01
                        12220222 1220202 101111010001
                        11112111 1112121 111111111111