


NO ./textures/walls/wall_2.xpm
EA ./textures/walls/wall_2.xpm
WE ./textures/walls/wall_2.xpm
S ./textures/enemy/enemy_Idle.xpm 
SO ./textures/walls/wall_2.xpm
F  ./textures/walls/floor_2.xpm
C ./textures/walls/ceiling.xpm
R 1900 1080

        1111111111111111111111111
        1000000000110000000000001
        1011002001110000020000001
        10H1000000000001000001001
111111111111001001110000000000001
1H00000000Q0000001110111110111111A111111111111111111111111
11110111111111011100000010001111A0A11111111011100000010001
1AAA0AAAAAAAHA0A11010100100011AAA0AAAAAAAHA0A1101010010001
1A000000AA0AQA0A11000200100011A000000AA0AQA0A1100000010201
A0000002000000000Q00000010001A0000000200000000Q00000000001
A0010000000000AA1010100010000000A000000000AAA1110100010001
1A00000AAA0A0A0A1111011110001AA00000AAA0A0Q0A1111001110001
1AAA0AAA 1AAHA0A 1011110100011AAAAAAA 1AA0AHA 101101HQ0001
1111A111 111A1A1 111111111Q11111111111111A1A1 111101111111
                        1000000000000000H1111111110111111
                        11110111111111011100000010001
                        1AAA0AAAAAAA0A0A1101010010001
                        1A000000AA0AQA0A1100000010001
                        A0000200000000000Q00000010001
                        A00A0A00000000A11010100010001
                        1A00000AAA0A0A0A1111011110N01
                        1AAA0AAA 1AA0A0A 101111010001
                        1111A111 111A1A1 111111111111